#info
scale=1.3
music=techno03
background=backdrop_looped

#player
startx=4
starty=10
velocityx=100

#size
width=119
heigth=17

#tiles
11 11 11 11 11 11 11 11 11 11 11 11 11 11 11 11 11 11 11 11 11 11 11 11 11 11 11 11 11 11 11 11 12 12 12 12 11 11 11 11 11 11 11 11 11 11 11 11 11 11 11 11 11 11 11 11 11 11 11 11 11 11 11 11 11 11 12 12 12 12 12 11 11 11 11 11 11 11 11 11 11 11 11 11 11 11 11 11 11 11 11 11 11 11 21 -- -- -- -- -- 01 11 11 11 11 11 11 11 11 11 11 11 11 11 11 11 11 11 --
11 11 11 11 11 11 11 11 11 11 11 11 11 11 11 11 11 11 11 11 11 12 12 11 11 11 11 12 12 12 12 22 -- 37 47 47 01 11 11 11 11 11 11 11 11 11 11 11 11 11 11 11 11 11 11 11 11 11 11 11 11 11 11 11 11 21 -- -- -- -- -- 01 11 11 11 11 11 11 11 11 11 11 11 11 11 11 11 11 11 11 11 11 11 11 21 -- -- -- -- -- 01 11 11 11 11 11 11 11 11 11 11 11 11 11 11 11 11 11 --
11 11 11 11 11 11 11 11 11 11 11 11 11 11 11 11 11 11 11 11 21 -- -- 01 11 11 21 -- -- -- -- -- -- -- -- -- 01 11 11 11 11 11 11 11 11 11 11 11 11 11 11 11 11 11 11 11 11 11 11 11 11 11 11 11 12 22 -- -- -- -- -- 02 12 12 12 11 11 11 11 11 11 11 11 11 11 11 11 11 11 11 11 11 11 11 21 -- -- -- -- -- 01 11 11 11 11 11 11 11 11 11 11 11 11 11 11 11 11 11 --
11 11 11 11 11 11 11 11 11 11 11 11 11 11 11 11 11 11 11 11 21 47 47 01 11 11 22 -- -- -- -- -- -- -- -- -- 02 12 11 11 11 11 11 11 11 11 11 11 11 11 11 11 11 11 11 11 11 11 11 11 11 11 11 21 -- -- -- -- -- -- -- -- -- -- -- 02 12 12 12 12 11 11 11 11 11 11 11 11 11 11 11 11 11 11 21 -- -- -- -- -- 01 11 11 11 11 11 11 11 11 11 11 11 11 11 11 11 11 11 --
11 11 11 11 11 11 11 11 11 11 11 11 11 11 11 11 11 11 11 11 22 -- -- 02 11 22 -- -- -- -- 41 -- -- -- -- -- -- 68 01 11 11 11 11 11 11 11 11 11 11 11 11 11 11 11 11 11 11 11 11 11 11 11 11 21 -- -- -- -- -- -- 41 -- -- -- -- -- 42 -- -- -- 01 11 11 11 11 11 11 11 11 11 11 11 11 11 21 -- -- -- -- -- 01 11 11 11 11 11 11 11 11 11 11 11 11 11 11 11 11 11 --
11 11 11 11 11 11 12 12 12 12 12 12 12 12 12 11 11 11 -- -- -- -- -- -- -- -- -- -- -- -- 42 -- -- -- -- -- -- 69 01 11 11 11 11 11 11 11 11 11 11 11 11 11 11 11 11 11 11 11 11 11 11 11 11 21 -- -- -- -- -- -- 42 -- -- -- -- -- 42 -- -- -- 02 12 12 12 12 12 11 11 11 11 11 11 11 11 21 47 47 47 47 47 01 11 11 11 11 11 11 11 11 11 11 11 11 11 11 11 11 11 --
11 11 11 11 11 21 -- -- -- -- 42 -- 37 47 47 01 11 21 -- -- -- -- -- -- -- -- -- -- -- 00 10 20 -- -- -- -- -- -- 02 12 12 12 12 12 12 12 12 12 12 12 12 12 12 12 12 12 11 11 11 11 11 11 12 22 -- -- -- -- 00 10 10 10 10 20 -- -- 42 -- -- -- -- 37 47 47 57 -- 67 01 11 11 11 11 11 11 21 -- -- -- -- -- 01 11 11 11 11 11 11 11 11 11 11 11 11 11 11 11 11 11 --
11 12 12 12 12 22 -- -- -- -- 42 -- -- -- -- 02 12 22 -- -- -- -- -- -- -- -- -- -- 67 01 11 21 -- -- -- -- -- -- -- -- 37 47 47 47 57 -- -- -- 37 47 47 47 57 -- -- -- 01 11 11 11 11 21 -- -- -- -- -- -- 01 11 11 11 11 21 77 -- 42 -- -- -- -- -- -- -- -- -- 68 02 12 12 12 12 12 12 22 -- -- -- -- -- 02 12 12 12 12 12 12 12 12 12 12 12 12 12 12 12 12 12 91
21 47 47 57 -- -- -- -- -- -- 42 -- -- -- -- -- 42 -- -- -- -- -- -- -- -- -- -- -- 68 01 11 21 17 27 -- -- -- -- -- -- -- -- -- -- -- -- -- -- -- -- -- -- -- -- -- -- 01 11 11 11 11 21 -- -- -- -- -- 67 01 11 11 11 11 31 10 10 10 20 -- -- -- -- -- -- -- -- 68 -- -- -- -- -- -- 42 -- -- -- -- -- -- -- 99 -- -- 42 -- 37 47 47 57 -- -- -- -- -- -- -- 81 91
21 -- -- -- -- -- -- -- -- 00 10 10 20 -- -- -- 42 -- -- -- 07 17 17 17 27 -- -- -- 68 01 11 31 10 10 10 20 -- -- -- -- -- -- -- -- -- -- -- -- -- -- -- -- -- -- -- -- 02 12 12 12 12 22 -- -- -- -- -- 68 01 11 11 11 11 11 12 12 12 22 -- -- -- -- -- -- -- -- 68 -- -- -- 41 -- -- 42 -- -- -- -- -- -- -- 99 41 -- 42 -- -- -- -- -- -- -- -- -- -- -- -- 81 91
21 -- -- -- -- -- -- -- -- 01 11 11 31 10 10 10 10 10 10 10 20 -- -- 00 10 10 10 10 10 30 11 11 11 11 11 21 -- -- -- -- -- -- -- -- -- -- -- -- -- -- -- -- -- -- -- -- -- -- 42 -- -- -- -- -- -- -- -- 68 01 11 11 11 11 21 79 -- -- -- -- -- -- -- -- -- -- -- 68 -- -- -- 42 -- 00 10 10 20 -- -- -- 00 10 10 10 10 10 10 10 10 10 10 10 10 10 10 10 10 10 10 91
31 10 10 10 10 10 10 10 10 30 11 11 11 11 11 11 11 11 11 11 21 -- -- 01 11 11 11 11 11 11 11 11 11 11 11 11 10 10 10 20 -- -- -- -- 07 17 17 17 17 27 -- -- -- -- -- -- -- -- 42 -- -- -- -- -- -- -- -- 69 02 12 12 12 12 22 -- -- -- -- -- -- -- -- -- -- -- -- 32 -- -- -- 42 -- 01 11 11 21 17 17 17 01 11 11 11 11 11 11 11 11 11 11 11 11 11 11 11 11 11 11 --
11 11 11 11 11 11 11 11 11 11 11 11 11 11 11 11 11 11 11 11 31 10 10 30 11 11 11 11 11 11 11 11 11 11 11 11 11 11 11 31 10 10 10 10 10 10 10 10 10 10 20 -- -- 41 -- -- -- -- 42 -- -- 07 17 27 -- -- -- -- -- 42 -- 42 -- -- -- -- -- -- -- 07 17 17 27 -- -- -- -- -- -- 00 10 10 30 11 11 21 -- -- -- 01 11 11 11 11 11 11 11 11 11 11 11 11 11 11 11 11 11 11 --
11 11 11 11 11 11 11 11 11 11 11 11 11 11 11 11 11 11 11 11 11 11 11 11 11 11 11 11 11 11 11 11 11 11 11 11 11 11 11 11 11 11 11 11 11 11 11 11 11 11 21 -- -- 42 -- 41 -- 00 10 10 10 10 10 10 10 10 10 10 10 10 10 10 10 10 10 10 10 10 10 10 20 -- 00 10 10 20 -- -- -- 01 11 11 11 11 11 21 -- -- -- 01 11 11 11 11 11 11 11 11 11 11 11 11 11 11 11 11 11 11 --
11 11 11 11 11 11 11 11 11 11 11 11 11 11 11 11 11 11 11 11 11 11 11 11 11 11 11 11 11 11 11 11 11 11 11 11 11 11 11 11 11 11 11 11 11 11 11 11 11 11 21 -- -- 42 -- 42 -- 01 11 11 11 11 11 11 11 11 11 11 11 11 11 11 11 11 11 11 11 11 11 11 21 -- 01 11 11 31 10 10 10 30 11 11 11 11 11 21 -- -- -- 01 11 11 11 11 11 11 11 11 11 11 11 11 11 11 11 11 11 11 --
11 11 11 11 11 11 11 11 11 11 11 11 11 11 11 11 11 11 11 11 11 11 11 11 11 11 11 11 11 11 11 11 11 11 11 11 11 11 11 11 11 11 11 11 11 11 11 11 11 11 31 10 10 10 10 10 10 30 11 11 11 11 11 11 11 11 11 11 11 11 11 11 11 11 11 11 11 11 11 11 21 -- 01 11 11 11 11 11 11 11 11 11 11 11 11 21 -- -- -- 01 11 11 11 11 11 11 11 11 11 11 11 11 11 11 11 11 11 11 --
11 11 11 11 11 11 11 11 11 11 11 11 11 11 11 11 11 11 11 11 11 11 11 11 11 11 11 11 11 11 11 11 11 11 11 11 11 11 11 11 11 11 11 11 11 11 11 11 11 11 11 11 11 11 11 11 11 11 11 11 11 11 11 11 11 11 11 11 11 11 11 11 11 11 11 11 11 11 11 11 21 -- 01 11 11 11 11 11 11 11 11 11 11 11 11 21 -- -- -- 01 11 11 11 11 11 11 11 11 11 11 11 11 11 11 11 11 11 11 --