#info
name=Chapter 1: Spiky Hell
scale=1.3
music=techno03
background=bg0

#player
startx=3
starty=8
velocityx=100

#size
width=41
heigth=20

#tiles
11 11 11 11 11 11 11 11 11 11 11 11 11 11 11 11 12 12 12 12 12 12 12 12 12 12 11 11 11 11 11 11 11 11 11 11 11 11 11 11 11
11 11 11 11 11 11 11 11 11 11 11 11 11 11 11 21 05 -- -- -- -- -- -- -- -- -- 02 12 12 11 11 11 11 11 11 11 11 11 11 11 11
11 11 11 11 11 11 11 11 11 11 11 11 11 11 11 21 -- -- -- -- -- -- 41 -- -- -- -- -- 25 01 11 11 11 11 11 11 11 11 11 11 11
11 11 11 11 11 11 11 11 11 11 11 11 11 11 11 21 -- -- -- -- -- -- 42 -- -- -- -- -- -- 02 12 11 11 11 11 11 11 11 11 11 11
11 11 11 11 11 11 11 11 11 11 11 11 11 11 11 21 -- -- -- -- -- -- 42 -- -- -- -- -- -- -- 25 01 11 11 11 11 11 11 11 11 11
11 12 12 11 11 11 11 11 11 11 11 11 11 11 11 21 -- -- -- -- -- -- 42 -- -- -- -- -- -- -- -- 02 11 11 11 11 11 11 11 11 11
80 90 -- 02 12 12 12 12 12 12 12 12 12 12 12 22 -- -- -- -- -- 00 10 20 -- -- -- -- -- -- -- -- 01 11 11 11 11 11 11 11 11
80 90 -- -- -- -- -- -- -- -- -- 15 -- -- -- -- -- -- -- 00 10 30 11 31 20 -- -- -- -- -- -- -- 02 11 11 11 11 11 11 11 11
80 90 -- -- -- -- -- 16 -- -- -- -- -- -- -- -- -- -- 26 01 30 11 11 11 31 20 -- -- -- -- -- -- -- 02 11 11 11 11 11 11 11
31 10 10 10 10 10 10 10 10 10 10 10 10 10 10 10 10 10 10 30 11 11 11 11 11 31 10 20 -- -- -- -- -- -- 02 12 11 11 11 11 11
11 11 11 11 11 11 11 11 11 11 11 11 11 11 11 11 11 11 11 11 11 11 11 11 11 11 11 31 10 20 -- -- -- -- -- -- 02 12 12 12 11
11 11 11 11 11 11 11 11 11 11 11 11 11 11 11 11 11 11 11 11 11 11 11 11 11 11 11 11 11 21 -- -- -- -- -- -- -- -- -- 61 71
11 11 11 11 11 11 11 11 11 11 11 11 11 11 11 11 11 11 11 11 11 11 11 11 11 11 11 11 11 31 20 -- -- -- -- -- -- -- -- 61 71
11 11 11 11 11 11 11 11 11 11 11 11 11 11 11 11 11 11 11 11 11 11 11 11 11 11 11 11 11 11 31 10 20 -- -- -- -- -- -- 61 71
11 11 11 11 11 11 11 11 11 11 11 11 11 11 11 11 11 11 11 11 11 11 11 11 11 11 11 11 11 11 11 11 31 10 10 10 10 10 10 10 30
11 11 11 11 11 11 11 11 11 11 11 11 11 11 11 11 11 11 11 11 11 11 11 11 11 11 11 11 11 11 11 11 11 11 11 11 11 11 11 11 11
11 11 11 11 11 11 11 11 11 11 11 11 11 11 11 11 11 11 11 11 11 11 11 11 11 11 11 11 11 11 11 11 11 11 11 11 11 11 11 11 11
11 11 11 11 11 11 11 11 11 11 11 11 11 11 11 11 11 11 11 11 11 11 11 11 11 11 11 11 11 11 11 11 11 11 11 11 11 11 11 11 11
11 11 11 11 11 11 11 11 11 11 11 11 11 11 11 11 11 11 11 11 11 11 11 11 11 11 11 11 11 11 11 11 11 11 11 11 11 11 11 11 11
11 11 11 11 11 11 11 11 11 11 11 11 11 11 11 11 11 11 11 11 11 11 11 11 11 11 11 11 11 11 11 11 11 11 11 11 11 11 11 11 11