#info
name=Chapter 0: Tutorial
scale=1.3
background=bg1

#player
startx=1
starty=8
velocityx=100

#size
width=41
heigth=20

#tiles
11 11 11 11 11 11 11 11 11 11 11 11 11 11 11 11 12 12 12 12 12 12 12 11 11 11 11 11 11 11 11 11 11 11 11 11 11 11 11 11 11
11 11 11 11 11 11 11 11 11 -- -- -- -- -- -- -- -- -- -- -- -- -- 81 91 11 11 11 11 11 11 11 11 11 11 11 11 11 11 11 11 11
-- -- -- -- -- -- -- -- -- -- -- -- -- -- -- -- -- -- -- -- -- -- 81 91 11 11 11 11 11 11 11 11 11 11 11 11 11 11 11 11 11
-- -- -- -- -- -- -- -- -- -- -- -- -- -- -- -- -- -- -- -- -- -- 81 91 11 11 11 11 11 11 11 11 11 11 11 11 11 11 11 11 11
-- -- -- -- -- -- -- -- -- -- -- -- -- -- -- -- -- -- -- -- -- -- 81 91 11 11 11 11 11 11 11 11 11 11 11 11 11 11 11 11 11
-- -- -- -- -- -- -- -- -- -- -- -- -- -- -- -- -- -- -- -- -- -- 81 91 11 11 11 11 11 11 11 11 11 11 11 11 11 11 11 11 11
-- -- -- -- -- -- -- -- -- -- -- -- -- -- -- -- -- -- -- -- -- 00 10 30 11 11 11 11 11 11 11 11 11 11 11 11 11 11 11 11 11
-- -- -- -- -- -- -- -- -- -- -- -- -- -- -- -- -- -- -- -- 00 30 11 11 11 11 11 11 11 11 11 11 11 11 11 11 11 11 11 11 11
-- -- -- -- -- -- -- -- -- -- -- -- -- -- -- -- -- -- -- 00 30 11 11 11 11 11 11 11 11 11 11 11 11 11 11 11 11 11 11 11 11
10 10 10 10 10 13 13 10 10 10 10 10 10 10 10 43 43 10 10 30 11 11 11 11 11 11 11 11 11 11 11 11 11 11 11 11 11 11 11 11 11
11 11 11 11 11 11 11 11 11 11 11 11 11 11 11 11 11 11 11 11 11 11 11 11 11 11 11 11 11 11 11 11 11 11 11 11 11 11 11 11 11
11 11 11 11 11 11 11 11 11 11 11 11 11 11 11 11 11 11 11 11 11 11 11 11 11 11 11 11 11 11 11 11 11 11 11 11 11 11 11 11 11
11 11 11 11 11 11 11 11 11 11 11 11 11 11 11 11 11 11 11 11 11 11 11 11 11 11 11 11 11 11 11 11 11 11 11 11 11 11 11 11 11
11 11 11 11 11 11 11 11 11 11 11 11 11 11 11 11 11 11 11 11 11 11 11 11 11 11 11 11 11 11 11 11 11 11 11 11 11 11 11 11 11
11 11 11 11 11 11 11 11 11 11 11 11 11 11 11 11 11 11 11 11 11 11 11 11 11 11 11 11 11 11 11 11 11 11 11 11 11 11 11 11 11
11 11 11 11 11 11 11 11 11 11 11 11 11 11 11 11 11 11 11 11 11 11 11 11 11 11 11 11 11 11 11 11 11 11 11 11 11 11 11 11 11
11 11 11 11 11 11 11 11 11 11 11 11 11 11 11 11 11 11 11 11 11 11 11 11 11 11 11 11 11 11 11 11 11 11 11 11 11 11 11 11 11
11 11 11 11 11 11 11 11 11 11 11 11 11 11 11 11 11 11 11 11 11 11 11 11 11 11 11 11 11 11 11 11 11 11 11 11 11 11 11 11 11
11 11 11 11 11 11 11 11 11 11 11 11 11 11 11 11 11 11 11 11 11 11 11 11 11 11 11 11 11 11 11 11 11 11 11 11 11 11 11 11 11
11 11 11 11 11 11 11 11 11 11 11 11 11 11 11 11 11 11 11 11 11 11 11 11 11 11 11 11 11 11 11 11 11 11 11 11 11 11 11 11 11